37
0 3 42 42 42 42 42 42
1 0 42 42 42 42 42 42
2 3 42 42 42 42 42 42
3 3 42 42 42 42 42 42
4 0 42 42 42 42 42 42
5 3 42 42 42 42 42 42
6 3 42 42 42 42 42 42
7 2 42 42 42 42 42 42
8 0 42 42 42 42 42 42
9 2 42 42 42 42 42 42
10 2 42 42 42 42 42 42
11 2 42 42 42 42 42 42
12 2 42 42 42 42 42 42
13 2 42 42 42 42 42 42
14 0 42 42 42 42 42 42
15 2 42 42 42 42 42 42
16 2 42 42 42 42 42 42
17 2 42 42 42 42 42 42
18 2 42 42 42 42 42 42
19 1 42 42 42 42 42 42
20 1 42 42 42 42 42 42
21 0 42 42 42 42 42 42
22 1 42 42 42 42 42 42
23 1 42 42 42 42 42 42
24 1 42 42 42 42 42 42
25 1 42 42 42 42 42 42
26 1 42 42 42 42 42 42
27 0 42 42 42 42 42 42
28 1 42 42 42 42 42 42
29 1 42 42 42 42 42 42
30 0 42 42 42 42 42 42
31 1 42 42 42 42 42 42
32 1 42 42 42 42 42 42
33 1 42 42 42 42 42 42
34 1 42 42 42 42 42 42
35 1 42 42 42 42 42 42
36 0 42 42 42 42 42 42
0
20
2 0
2 0 0
4
22 1 0 0
26 1 0 0
31 1 1 0
35 1 1 0
1
lol