37
0 3 42 42 42 42 42 42
1 3 42 42 42 42 42 42
2 3 42 42 42 42 42 42
3 0 42 42 42 42 42 42
4 3 42 42 42 42 42 42
5 3 42 42 42 42 42 42
6 0 42 42 42 42 42 42
7 2 42 42 42 42 42 42
8 2 42 42 42 42 42 42
9 0 42 42 42 42 42 42
10 2 42 42 42 42 42 42
11 2 42 42 42 42 42 42
12 0 42 42 42 42 42 42
13 2 42 42 42 42 42 42
14 2 42 42 42 42 42 42
15 0 42 42 42 42 42 42
16 2 42 42 42 42 42 42
17 2 42 42 42 42 42 42
18 0 42 42 42 42 42 42
19 0 42 42 42 42 42 42
20 1 42 42 42 42 42 42
21 1 42 42 42 42 42 42
22 0 42 42 42 42 42 42
23 1 42 42 42 42 42 42
24 1 42 42 42 42 42 42
25 1 42 42 42 42 42 42
26 1 42 42 42 42 42 42
27 1 42 42 42 42 42 42
28 0 42 42 42 42 42 42
29 1 42 42 42 42 42 42
30 1 42 42 42 42 42 42
31 0 42 42 42 42 42 42
32 1 42 42 42 42 42 42
33 1 42 42 42 42 42 42
34 1 42 42 42 42 42 42
35 1 42 42 42 42 42 42
36 1 42 42 42 42 42 42
0
20
2 0
2 0 0
4
21 1 1 0
26 1 1 0
30 1 0 0
35 1 0 0
1
la